10 6
. . . # . . . . . #
. . # . . . . . . .
. . . . . # . . # .
. . . . . . . . . .
# . . . . . . . . .
. . # . . . . # . .
. . . . . . . . . #
. . . # . . . . . .
. . . . . # . . . .
# . . . . . . . . .
2 4 0
6 7 1
1 8 2
3 2 3
8 9 0
7 4 1